%%%%%%%%%%
w.      Pw
%%%%%%%%%%
